Lugar,País,Código País,Oro,Plata,Bronce,Total
1, Estados Unidos,EUA,46,37,38,121
2, Reino Unido,UK,27,23,17,67
3, China,CH,26,18,26,70
4, Rusia,RUS,19,18,19,56
5, Alemania,DEU,17,10,15,42
6, Japón,JP,12,8,21,41
7, Francia,FR,10,18,14,42
8, Corea del Sur,KOR,9,3,9,21
9, Italia,IT,8,12,8,28
10, Australia,AUS,8,11,10,29
