Lugar,País,Código País,Oro,Plata,Bronce,Total
11, Países Bajos,NLD,8,7,4,19
12, Hungría,HU,8,3,4,15
13, Brasil,BR,7,6,6,19
14, España,ESP,7,4,6,17
15, Kenia,KE,6,6,1,13
16, Jamaica,JA,6,3,2,11
17, Croacia,CR,5,3,2,10
18, Cuba,CU,5,2,4,11
19, Nueva Zelanda,NZ,4,9,5,18
20, Canadá,CA,4,3,15,22